########################################
#......................................#
#......................................#
#......................................#
#......................................#
#.........#######################......#
#.........#.....................#......#
#.........#.....................#......#
#.........#.....................#......#
#.........#.....................#......#
#.........#...#.....#########...#......#
#.........#...#.............#...#......#
#.............#.............#...#......#
#.............#.............#...#......#
#.............#.....#########...#......#
#.............#.............#...#......#
#.............#.............#..........#
#.............#.............#..........#
#.............####..#########..........#
#...............................#......#
#.........#.....................#......#
#.........#.....................#......#
#.........#.....................#......#
#.........#.....................#......#
#.........#.....................#......#
#.........#.....................#......#
#.........#.....................#......#
#.........#.....................#......#
#......................................#
########################################
........................................
........................................
........................................
........................................
........................................
........................................
........................................
........................................
........................................
........................................