########################################
#......................................#
#......................................#
#......................................#
#......................................#
#.........#######################......#
#.........#.....................#......#
#.........#.....................#......#
#...............................#......#
#...................#...........#......#
#...................####........#......#
#...................#...........#......#
#...................#...........#......#
#...................#...........#......#
#...................#...........#......#
#...................#...........#......#
#...................#..................#
#...................#..................#
#......................................#
#...............................#......#
#.........#.....................#......#
#.........#.....................#......#
#.........#.....................#......#
#.........#.....................#......#
#.........#.....................#......#
#.........#.........#...........#......#
#.........#.........#...........#......#
#.........#.........#...........#......#
#......................................#
########################################
........................................
........................................
........................................
........................................
........................................
........................................
........................................
........................................
........................................
........................................