########################################
#......................................#
#......................................#
#......................................#
#......................................#
#.........#######################......#
#.........#.....................#......#
#.........#.....................#......#
#...............................#......#
#..................##...........#......#
#.................#.#...........#......#
#................#..#...........#......#
#...................#...........#......#
#...................#...........#......#
#...................#...........#......#
#...................#...........#......#
#...................#..................#
#...................#..................#
#................#######...............#
#...............................#......#
#.........#.....................#......#
#.........#.....................#......#
#.........#.....................#......#
#.........#.....................#......#
#.........#.....................#......#
#.........#.........#...........#......#
#.........#.........#...........#......#
#.........#.........#...........#......#
#......................................#
########################################
........................................
........................................
........................................
........................................
........................................
........................................
........................................
........................................
........................................
........................................