########################################
#......................................#
#......................................#
#......................................#
#......................................#
#.........#######################......#
#.........#.....................#......#
#.........#.....................#......#
#.........#.....................#......#
#.........#.....................#......#
#.........#...#.....#########...#......#
#.........#...#.............#...#......#
#.............#.............#...#......#
#.............#.............#...#......#
#.............#.............#...#......#
#.............#.....#########...#......#
#.............#.....#..................#
#.............#.....#..................#
#.............####..#########..........#
#...............................#......#
#.........#.....................#......#
#.........#.....................#......#
#.........#.....................#......#
#.........#.....................#......#
#.........#.....................#......#
#.........#.....................#......#
#.........#.....................#......#
#.........#.....................#......#
#......................................#
########################################
........................................
........................................
........................................
........................................
........................................
........................................
........................................
........................................
........................................
........................................